Ezogelin Corbasi : mercimek pirinc bulgur sogan nane
Domates Corbasi : domates tereyag un sut kasar
Yayla Corbasi : yogurt un limon yumurta biber pirinc nane
Tavuk Corbasi : tavuk sehriye zeytinyagi un yumurta sarimsak limon
Sehriye Corbasi  : sogan sarimsak tereyagi  salca domates sehriye
Mercimek Corbasi : aycicekyagi sogan un havuc patates mercimek
Misket Kofte Corbasi : et bulgur sogan yumurta sarimsak pulbiber karabiber maydanoz
Tekirdag Koftesi : kıyma sarımsak irmik soğan ekmek karbonat yumurta kimyon
Yalanci Beyti : yufka kıyma soğan yumurta kabartmatozu karabiber pulbiber tuz
Citir Tavuk : tavuk yogurt un mısırgevregi yağ pulbiber kimyon su
Tavuk Sis : tavuk soğan yogurt zeytinyagi kimyon biber kekik
Sultan Kebabi : yufka et bezelye patlıcan salça soğan tereyağı tuz
Ratatuy : patlıcan kabak patates domates zeytinyagi tuz kekik domates
Hatay Usulu Doner : tavuk patates kıvırcıkmarul domates soğan tuz kekik pulbiber karabiber iskendersos
Mantar Sote : mantar soğan domates biber salça yağ maydanoz
Yeni Dunya Kebabi : maltaerigi kiyma soğan biber domates karabiber
Adana Kebabi : kıyma soğan sarımsak kapyabiber bibersalca tuz karabiber pulbiber
Sebzeli Lazanya : lazanya kabak havuç soğan bezelye zeytinyağı mısır kaşarpeyniri
Magnolya : süt un nişasta yumurta vanilya krema bisküvi
Karamelli Triliçe : yumurta şeker su yağ kabartmatozu vanilin
Waffle : yumurta tozseker kabartmatozu vanilya tuz un süt yağ
Revani : yumurta şeker aycicekyagi irmik yogurt vanilin
Kibris Tatlisi : yumurta şeker yağ ceviz un kabartmatozu
Sufle : nisasta cikolata süt seker tereyagi
Izmir Bomba : cikolata un süt 
Limonata : limon su
Elma Suyu : elma su
Havuc Suyu : havuc su
Deteoks : maydonoz dereotu keciboynuzu limon
Turk Kahvesi : kafein
Sicak Cikolata : cikolata su
Soguk Kahve : kafein
Coca Cola : kola
Su : su